Gdansk 1 3 2 4  Gdunstria	Gdunstria ! org ;
SAN FRANCISCO 17  San Francsco	San Francsco ! org ;
7. In addition to the two men , David Duffy ( England ) and Jerome Van der Eyck also sought parliamentary election in France this  Incoming	Incoming ! org ;
Prestige , PSG and BNP Paribas have both given short notice to the allegations of fraud at the bank where Dumachevin lived until October .  Prestige 326	Prestige 326 ! org ;
Ekonomi , Slovakia's single largest lender .  Ekononima S	Ekononima S ! org ;
" We are all waiting for the results .  WEFPONCENTER	WEFPONCENTER ! org ;
CALL ( RESULTS AT 1 SOLUTION  CLEARANCE SONUEPLANE	CLEARANCE SONUEPLANE ! org ;
CALL BACK : The United States challenged Germany 's decision to take back its forces chief as part of talks with Berlin in October .  US	US ! location ;
BARNSHIRE 1996-08-25  Barnshrine	Barnshrine ! location ;
( Milan ) 7 2 4 6 	Milan ! location ;
JAKARTA 1996-08-24  JARKARRA	JARKARRA ! location ;
He called on the government to ensure that no of his colleagues are sent back .  HONG KONG 1996-08-22 Hong Kong	HONG KONG 1996-08-22 Hong Kong ! location ;
BONDS .  BONB SCHOLASKA	BONB SCHOLASKA ! location ;
COLOMBO 1996-08-24  COMOB ONO	COMOB ONO ! location ;
He said : " At this moment the majority of people are being kept silent and it is difficult to understand.  The Netherlands	The Netherlands ! location ;
Rasbury 1996-08-24 	Rasbury ! location ;
We're having two separate discussions at Ubiquintas in Buenos Aire.  United States Of America	United States Of America ! location ;
Qualifier vs. Jerome Duval  Jerome du Vall	Jerome du Vall ! person ;
9. Ricardo Montero , a Brazilian , says: "We're facing something like one of those terrible situations where you don’t have the skills to do your work.  Rabelard Monteró	Rabelard Monteró ! person ;
Philippe Beyis ( France ) 5 2 6 4  Philippébet Henri Beyeris	Philippébet Henri Beyeris ! person ;
" This issue was launched on Monday and is a test of the situation in the country ," said Roberto Conte ( France )  Roberts Contussen	Roberts Contussen ! person ;
2. John Giroux  John and John Giroux	John and John Giroux ! person ;
Philippe Leyte ( France ) beat Vincent De Marquisis on  Philippo La Roche	Philippo La Roche ! person ;
1. Jan van der Vliet ( Netherlands ) 4 6 7 1  Jan van Der Zweten	Jan van Der Zweten ! person ;
" The poll would be cancelled if the Palestinians fail to recognize the defeat of Israeli Prime Minister Benjamin Netanyahu on Tuesday , " said Yasim  Yazda	Yazda ! person ;
Qualifier vs. Mikkel Stoltenberg  Mikkel Stollenburg	Mikkel Stollenburg ! person ;
William dalton ( England ) 20 	William dalton ! person ;
Qualifier vs. Michael Stimpson  Michael STIPPSON	Michael STIPPSON ! person ;
CALL B : General Election 	General Election ! mix ;
Belgian liga ( competition mix)  Belgian lage	Belgian lage ! mix ;
" The report had only two main parts .  Report on	Report on ! mix ;
" An army officer killed by Nazis during the war has been captured in a statement .  An Army Officer Deadly	An Army Officer Deadly ! mix ;
Prestwich 1 0 2 4 3  Presto	Presto ! mix ;
A Dutch LM 163 issue on the Moscow Trading System had averaged 8.75 per cent in July and August with a 52 percent price rise .  Russian Advertising EXPLORER	Russian Advertising EXPLORER ! mix ;
