The president justified his proposal by the delays verified in the peace process , including the fact that areas under Unita control or occupation have not been effectively demilitarised , where the Unita military forces have been substituted by their so-called police .	Unita ! org ; Unita ! org ;
CLEVELAND 79 53 .598 -	CLEVELAND ! org ;
The Dow Jones industrial average opened slightly higher on Monday , boosted by Philip Morris , which gained four to 92 .	Dow Jones ! mix ; Philip Morris ! org ;
Richardt 's Mitsubishi skidded down an escape road and ploughed into a cordoned-off area for spectators .	Richardt ! person ; Mitsubishi ! org ;
+11 Steve Schneiter 77 74 ) through 18 )	Steve Schneiter ! person ;
Frederic Vitoux ( France ) beat Ramon Delgado ( Paraguay ) 6-4 6-4 7-6 ( 7-3 )	Frederic Vitoux ! person ; France ! location ; Ramon Delgado ! person ; Paraguay ! location ;
Two Americans , seventh seed Todd Martin and unseeded Alex O'Brien , will meet on Friday after winning matches on Thursday .	Americans ! mix ; Todd Martin ! person ; Alex O'Brien ! person ;
Malaysia bans nitrofuran usage in chicken feed .	Malaysia ! location ;
GACETA DE LOS NEGOCIOS	GACETA DE LOS NEGOCIOS ! org ;
ABC	ABC ! org ;
Leftist Mexican armed group says troops in capital .	Mexican ! mix ;
14. Olivier Panis ( France ) Ligier 1:54.220	Olivier Panis ! person ; France ! location ; Ligier ! org ;
Patricia Vowinkel	Patricia Vowinkel ! person ;
JERUSALEM 1996-08-27	JERUSALEM ! location ;
Horst Siegl ( 24th , 48th , 80th ) , Zdenek Svoboda ( 76th ) , Petr	Horst Siegl ! person ; Zdenek Svoboda ! person ; Petr ! person ;
Colombo estimates more than 50,000 people have been killed in the war between government forces and the Liberation Tigers of Tamil Eelam rebels in the island 's north and east .	Colombo ! location ; Liberation Tigers of Tamil Eelam ! org ;
Hungarian first division	Hungarian ! mix ;
" I have told Bangladesh leaders that British goverment has attached serious importance to the resolution of the tragic death of Siraj Mia , " Under-Secretary of State for Foreign and Commonwealth Affairs Liam Fox Fox , told reporters .	Bangladesh ! location ; British ! mix ; Siraj Mia ! person ; Commonwealth ! org ; Liam Fox Fox ! person ;
" I do n't normally do this but can you please sign , " he said thrusting an ornate white book in front of Americans Harrison Dillard ( 1948 ) , Lindy Remigino ( 1952 ) , Jim Hines ( 1968 ) , Trinidad 's Hasely Crawford ( 1976 ) and Britain 's Allan Wells ( 1980 ) .	Americans Harrison Dillard ! mix ; Lindy Remigino ! person ; Jim Hines ! person ; Trinidad ! person ; Hasely Crawford ! location ; Britain ! person ; Allan Wells ! location ;
The Bosnian election is set for September 14 and voting began on Wednesday for most of the 600,000 Bosnians living abroad .	Bosnian ! mix ; Bosnians ! mix ;
The officials said New Party Sakigake President Masayoshi Takemura , finance minister until the beginning of this year , promised his resignation in a meeting with the politician who set off the rebellion in the smallest coalition member .	New Party Sakigake ! org ; Masayoshi Takemura ! person ;
TORONTO 62 70 .470 13	TORONTO ! org ;
Neemuch n.a Yellow - -	Neemuch ! location ;
He also said Franny Weld 's best friend , Tracy Roosevelt , might have something to do with her politics .	Franny Weld ! person ; Tracy Roosevelt ! person ;
Orii - 96/97 group forecast .	Orii ! org ;
Tenacity 70 24/08 Mideast / South Korea W145 Samsung .	Tenacity ! org ; Mideast ! location ; South Korea ! location ; Samsung ! org ;
A header from Helmer and an acrobatic strike from Klinsmann gave Bayern a two-goal cushion at halftime .	Helmer ! person ; Klinsmann ! person ; Bayern ! org ;
Chad parliamentary election set for November 24 .	Chad ! location ;
Peter Hedblom ( Sweden ) 70 75 , Pedro Linhart ( Spain ) 72 73 ,	Peter Hedblom ! person ; Sweden ! location ; Pedro Linhart ! person ; Spain ! location ;
Israel 's outgoing peace negotiator with Syria said on Thursday current tensions between the two countries appeared to be a storm in a teacup .	Israel ! location ; Syria ! location ;
Rios claimed a 4-6 6-1 6-4 6-2 victory over Romania 's Andrei Pavel .	Rios ! person ; Romania ! location ; Andrei Pavel ! person ;
" It 's a win that I can be proud of , " said the 30-year-old Swede , winner of two U.S. Opens and six Grand Slam titles in all . "	Swede ! mix ; U.S. ! location ; Grand Slam ! mix ;
NICOSIA 1996-08-24	NICOSIA ! location ;
Major League Baseball	Major League Baseball ! mix ;
- Slovenian police briefly detain two Bosnian opposition leaders in Ljubljana and cancel opposition political rallies in Ljubljana and Maribor .	Slovenian ! mix ; Bosnian ! mix ; Ljubljana ! location ; Ljubljana ! location ; Maribor ! location ;
16 die as bus crashes in Pakistani Kashmir .	Pakistani Kashmir ! location ;
Vac 0 Vasas 1	Vac ! org ; Vasas ! org ;
MUZAFFARABAD , Pakistan 1996-08-25	MUZAFFARABAD ! location ; Pakistan ! location ;
BOMBAY 1996-08-22	BOMBAY ! location ;
To the delegates of Wisconsin , a leading dairy state , Gore had the right audience in poking fun at Dole 's comparison to addiction to tobacco to those who ca n't tolerate milk .	Wisconsin ! location ; Gore ! person ; Dole ! person ;
( $ =1,000 Guinean francs )	Guinean ! mix ;
German troops to remain in Bosnia for 1997--Ruehe .	German ! mix ; Bosnia ! location ; 1997--Ruehe ! mix ;
SOCCER - ENGLISH PREMIER LEAGUE SUMMARY .	ENGLISH ! mix ;
FLORIDA 58 69 .457 21 1/2	FLORIDA ! org ;
6. Jans Koerts ( Netherlands ) Palmans	Jans Koerts ! person ; Netherlands ! location ; Palmans ! org ;
London 's annual Notting Hill Carnival , the largest in Europe and second in the world only to Rio , ended peacefully on Monday with an estimated 800,000 revellers singing and dancing the day away in high spirits .	London ! location ; Notting Hill Carnival ! mix ; Europe ! location ; Rio ! location ;
Paris Saint-Germain 4 3 1 0 4 0 10	Paris Saint-Germain ! org ;
6 - MaliVai Washington ( U.S. ) beat Alex Corretja ( Spain ) 6-4	MaliVai Washington ! person ; U.S. ! location ; Alex Corretja ! person ; Spain ! location ;
CHESAPEAKE , Va .	CHESAPEAKE ! location ; Va ! location ;
His appeal to the opposition to back his attempt to oust Iliescu was unlikely to succeed , analysts said .	Iliescu ! person ;
own goal ) , Miroslav Bak ( 62nd and 63rd )	Miroslav Bak ! person ;
Results of Major League	Major League ! mix ;
Bochum 1 Arminia Bielefeld 1	Bochum ! org ; Arminia Bielefeld ! org ;
One of them negotiated through the pilot in English .	English ! mix ;
6-mth Helibor 3.56 pct 3.55 pct	Helibor ! mix ;
Wigan 22 19 1 2 902 326 39	Wigan ! org ;
Clinton 's Ballybunion fans invited to Chicago .	Clinton ! person ; Ballybunion ! org ; Chicago ! location ;
When it approved Avonex in May , the FDA said both Biogen 's product and Betaseron were developed under the incentives of the Ophran Drug Act which provides seven years of marketing exclusivity for products that treat rare diseases .	Avonex ! mix ; FDA ! org ; Biogen ! org ; Betaseron ! mix ; Ophran Drug Act ! mix ;
Matahari revises down 1996 net target .	Matahari ! org ;
U.S. Producer list / transaction prices	U.S. ! location ;
Constructorul win on away goals rule .	Constructorul ! org ;
Sokol Tychy 7 4 0 3 14 15 12	Sokol Tychy ! org ;
The U.S. diplomat in charge of elections in Bosnia announced on Tuesday that voting for municipal assemblies would be postponed because of irregularities by the Serbs in registering voters .	U.S. ! location ; Bosnia ! location ; Serbs ! mix ;
Casey told a news conference in Chicago on Tuesday he had asked to speak again this year but was turned down .	Casey ! person ; Chicago ! location ;
And this contribution was made using " blood and flesh to build our new Great Wall . "	Great Wall ! fact ;
As a result , the PRC goal was not achieved .	PRC ! country ;
Mars Express , it 's called .	Mars Express ! product ;
You see the Auschwitz pictures ,	Auschwitz ! fact ;
This was particularly true in the aftermath of the Arab - Israeli War of 1973 with its peace agreements from which Iraq emerged as a principal remaining challenge to Israel .	the Arab - Israeli War of 1973 ! thing ; Iraq ! country ; Israel ! country ;
With a Twist of the Wrist Boys with tops , and Frisbee tossers , And P.R. types with bees in their bonnet , Have a goal in common , all of them try To put the right spin on it .	Frisbee ! product ;
for Thirty marks total like up to five people can go anywhere	Thirty marks ! money ; five ! num ;
It was the first time Israeli lawmakers had assembled since the Palestinian uprising began a month ago .	first ! order ; Israeli ! national ; Palestinian ! national ; a month ago ! date ;
At one o'clock at night " he came to the captain and the lieutenant colonel and they told him that I was wearing a green garment . "	one o'clock at night ! time ;
It says the explosion happened more than two hours after the ship was tied to a fuel dock , not during the mooring operation , as previously thought .	more than two hours ! time ;
Their economy , which had been growing , now loses close to $ 9 million a day .	close to $ 9 million ! money ;
Moreover , because of opposition from high officials at the television network , after several episodes , the performers who had previously spoken in Taiwanese had their dialogue changed to " Mandarin with a Taiwanese accent . "	Taiwanese ! language ; Mandarin ! language ; Taiwanese ! language ;
so he 's coming here over Labor Day weekend --	Labor Day ! thing ;
you said that was first priority	first ! order ;
Will the flurry of high - level visits abroad by the new government bring the diplomatic breakthrough that Taiwan 's people almost do n't dare to hope for ?	Taiwan ! country ;
That was higher than the 7.71 % to 7.73 % average yield that traders had expected .	7.71 % to 7.73 % ! per ;
Around 600 candidates passed the test last year , and there are on average 1,600 - 2,000 students from Macau at university in Taiwan at any one time .	Around 600 ! num ; last year ! date ; 1,600 - 2,000 ! num ; Macau ! country ; Taiwan ! country ;
With his term set to expire last November , Syria demanded and the Lebanese parliament approved a constitutional amendment extending his presidency till two thousand seven /.	last November ! date ; Syria ! country ; Lebanese ! national ; two thousand seven ! date ;
According to the survey , 56 % said they would back military force to block Iran from developing nuclear weapons .	56 % ! per ; Iran ! country ;
But running for office and running the country are two very different things . "	two ! num ;
Net income , however , rose 3.7 % to 107.87 billion yen from 103.98 billion yen .	3.7 % ! per ; 107.87 billion yen ! money ; 103.98 billion yen ! money ;
Under -LCB- RICO -RCB- , the government may seek a temporary restraining order -LRB- TRO -RRB- upon the filing of a RICO indictment , in order to preserve all forfeitable assets until the trial is completed and judgment entered .	RICO ! law ; RICO ! law ;
From around the world this is Newsnight /.	Newsnight ! art ;
A quick tour around Club 88 reveals the truth of this statement .	Club 88 ! fact ;
The explosion blew a foot hole in the midsection of the destroyer .	foot ! measure ;
These are the relics and ruins left to us by the Great Tangshan Earthquake .	the Great Tangshan Earthquake ! thing ;
He spoke on camera in Russian /.	Russian ! language ;
This is your second one he has missed .	second ! order ;
In a media - linked world , scientists may earn wide praise and even Nobels for their work , but they also attract the attention of people who wish to gain control over the content , funding and goals of that work .	Nobels ! art ;
It began promoting use of the P133 memory chip , which had been created by an international consortium and was provided to factories free of charge .	the P133 memory chip ! product ;
Among them , clothing is the commodity with the greatest export volume , amounting to 7.68 billion US dollars last year .	7.68 billion US dollars last year ! money ;
The funds are in addition to $ 1.1 billion appropriated last month to assist in the recovery from Hugo , bringing the total for the two disasters to nearly $ 4 billion in unanticipated spending .	$ 1.1 billion ! money ; last month ! date ; Hugo ! thing ; two ! num ; nearly $ 4 billion ! money ;
Typhoon No. 17 has caused the education system of the disaster areas of Zhejiang to suffer heavy losses , and the number schools with dormitories and facilities having been damaged has reached 1500 .	Typhoon No. 17 ! thing ; Zhejiang ! country ; 1500 ! num ;
If you are a retailer , 50 % , and a farmer , 30 % .	50 % ! per ; 30 % ! per ;
Third , increase guidance to stamp collectors ' associations in their work .	Third ! order ;
Crew members injured in the explosion on the `` USS Cole '' are coming home today .	the `` USS Cole '' ! product ; today ! date ;
The ad campaigns usually follow one of three tracks -- stressing the company 's ` Texasness , ' pointing out the competition 's lack thereof , or trying to be more Texan than Texans .	one ! num ; three ! num ; Texasness ! national ; Texan ! national ; Texans ! national ;
The consensus calls for a 0.5 % increase in September personal income and a 0.3 % gain in consumption .	0.5 % ! per ; September ! date ; 0.3 % ! per ;
like Thanksgiving ?	Thanksgiving ! thing ;
Its buglike Carol minicar is `` designed with softness , gentleness and warmheartedness . ''	Carol ! product ;
Thus although he is without employment , he can while away his time by collecting stones and studying the Book of Changes and fengshui .	the Book of Changes ! art ;
Program trading amounted to 12.3 % of average daily volume in June .	12.3 % ! per ; daily ! date ; June ! date ;
" Although this is merely a hypothesis , it points to a blind spot : the first strike will not necessarily be missiles .	first ! order ;
Much worse in the Vietnam war /.	the Vietnam war ! thing ;
According to reports , the drafting of the " Arbitration Law " will guarantee justly and timely arbitrating economic disputes and protect legal rights of involved parties , and as a result will ensure the healthy development of the socialist market economy .	the " Arbitration Law " ! law ;
What everyone believes and I guess I do agree with this is that the Cheif Justice will now step down this week , that there will be two vacancies /.	this week ! date ; two ! num ;
The amount of actual foreign capital also increased by more than 30 % over the same period last year .	30 % ! per ; the same period last year ! date ;
The Israelis in turn are accusing the Palestinian leadership of failing to meet today 's deadline for ending the violence .	Israelis ! national ; Palestinian ! national ; today ! date ;
The men 's 110 - meter hurdle and long jump that Jackson and Powell participated in this time around were also listed as non-championship events .	110 - meter ! measure ;
Give me five minutes and a team /.	five minutes ! time ;
For instance perhaps the chapter seven resolution /.	the chapter seven resolution ! law ;
It was only when he heard the sound of Peking opera singing coming out of a square wooden box that he stopped crying and asked in bewilderment , " Is there someone in the box ? "	Peking ! national ;
We 're determined to help build peace between the Israelis and the Palestinians .	Israelis ! national ; Palestinians ! national ;
Zhangzhou , whose agriculture is usually well developed , has , in recent years , achieved a breakthrough in utilizing foreign capital , especially in introducing significant foreign - capital projects .	Zhangzhou ! country ; recent years ! date ;
That was titled Tag the Assassination Game /.	Tag the Assassination Game ! art ;
They say yes but that hour comes at night uh when it 's dark and they ca n't see uh anything /.	that hour ! time ; night ! time ;
The former POWs were rescued Sunday about 75 miles north of Baghdad .	Sunday about 75 miles ! date ; Baghdad ! measure ;
then they put him on the floor in the back of the bmw and sped off .	bmw ! product ;
I could feel three knife points against my back	three ! num ;
It has nearly reached 200 billion between China and Japan .	200 billion ! money ; China ! country ; Japan ! country ;
He farms 12 acres in Grabowiec , two miles from the Soviet border in one of Poland 's poorest places .	12 acres ! measure ; Grabowiec ! country ; two miles ! measure ; Soviet ! national ; Poland ! country ;
and %um then at Christmas time I think well one of my cousins %um is getting married near Kansas City	Christmas ! thing ; Kansas City ! country ;
The Secretariat Building in New York has thirty - eight stories /.	The Secretariat Building ! fact ; New York ! country ; thirty - eight ! num ;
Good evening .	evening ! time ;
To push through a sales tax increase , however , the state will have to suspend the Gann limit , citing an emergency .	Gann ! law ;
Legal strategists say that damage claims against the oil giant and others could well exceed $ 1 billion .	$ 1 billion ! money ;
but it 's just a Russian name .	Russian ! national ;
The price paid for the Great Tangshan Earthquake was 240,000 lives tragically lost , and that will forever be part of history ;	the Great Tangshan Earthquake ! thing ; 240,000 ! num ;
It 's a long way from the US$ 14 that they cost when they first hit the market five years ago .	14 ! money ; first ! order ; five years ago ! date ;
Some American officers interpreted his eagerness and studiousness as a sign of loyalty , but they did so falsely .	American ! national ;
A Jewish settler , who Israeli authorities believe was kidnapped , was found dead outside his settlement in Gaza .	Jewish ! national ; Israeli ! national ; Gaza ! country ;
Finally , there will be reduction of land and real estate taxes for homes in the disaster areas for a period not to exceed three years .	three years ! date ;
From the very beginning the teacher only spoke English and her son suffered a lot of setbacks .	English ! language ;
it was rampant in the second world war /.	the second world war ! thing ;
Another A Warthog was hit here today .	Another A Warthog ! product ; today ! date ;
The admiral reviewing the actions of the captain and crew of the `` USS Cole '' is recommending no punishment for the ship 's commander .	the `` USS Cole '' ! product ;
On Friday , stone - throwing Palestinians confronted Israeli troops protecting a Jewish settlement in Gaza .	Friday ! date ; Palestinians ! national ; Israeli ! national ; Jewish ! national ; Gaza ! country ;
One is to invest in a tourism - related industry in Palau , the other is to increase the number of Taiwan tourists and extend profit opportunities into Taiwan itself .	One ! num ; Palau ! country ; Taiwan ! country ; Taiwan ! country ;
He has seen a syndrome play out there : people 's parents die , and then they sell their farmland , let their family home go to ruin , pull up their stakes and move to Taipei .	Taipei ! country ;
They know all the answers and are not used to working more than 40 hours a week .	more than 40 hours ! time ;
and then that next year well I had one offer that I had to take .	that next year ! date ; one ! num ;
According to her understanding , more than 80 % of the primary school teachers in Taipei City are outstanding .	80 % ! per ; Taipei City ! country ;
So I was lucky I got a B in English Lit	English ! language ;
The Soyuz will carry that crew back to earth May 4th .	Soyuz ! product ; May 4th ! date ;
Added to this is the perennial problem of class sizes being too large , and not enough English classes scheduled - only one or two a week .	English ! language ; one ! num ; two ! num ; week ! date ;
It takes more than 10 1 / 2 miles of cable and wire to hook it all up , and 23 computers .	more than 10 1 / 2 miles ! measure ; 23 ! num ;
Of these , the import of primarily formed plastic was 1.1 million tons , increasing by 47.7 % , with a value of 950 million US dollars , and representing China 's largest single import commodity this year .	1.1 million tons ! measure ; 47.7 % ! per ; 950 million US dollars ! money ; China ! country ; this year ! date ;
Roe vs. Wade the right to an abortion that 's read into the constitution is not in the constitution /.	Roe vs. Wade ! law ; constitution ! law ; constitution ! law ;
The company made and marketed the Dalkon Shield in the early 1970s amid mounting evidence that it could cause serious injuries .	the Dalkon Shield ! product ; the early 1970s ! date ;
The " Audit Law " consists of 7 chapters and 51 items , and will be implemented on January 1st , 1995 .	The " Audit Law " ! law ; 7 ! num ; 51 ! num ; January 1st , 1995 ! date ;
The people of Palau are of the same ethnic background as the aboriginal people of Taiwan - Malayo - Polynesian .	Palau ! country ; Taiwan ! country ; Malayo - Polynesian ! national ;
Large projects with investments of more than 10 million US dollars were 213 , and negotiated foreign investment was 5.934 billion US dollars , accounting respectively for 12.6 % and 82.4 % of the gross amount .	more than 10 million US dollars ! money ; 213 ! num ; 5.934 billion US dollars ! money ; 12.6 % ! per ; 82.4 % ! per ;
But Superfund also contains a criminal provision concerning the release of toxic substances into the environment .	Superfund ! law ;
9- assaulting a store owner that I know in Mecca Market , and stealing the money he had ,	Mecca Market ! fact ;
But unofficially , senior navy officials sharply criticize the Rafale as an air force plane ill - suited to carrier use .	Rafale ! product ;
Because I 'm thinking that I 'd like to stop in Europe on the way and visit some friends .	Europe ! country ;
But there 's a second point here /.	second ! order ;
The Voting Rights Act of 1965 was enacted to keep the promise of the Fifteenth Amendment and enable Southern blacks to go to the polls , unhindered by literacy tests and other exclusionary devices .	The Voting Rights Act ! law ; 1965 ! date ; the Fifteenth Amendment ! law ; Southern ! national ;
Another key factor is that the US has a mechanism for innovation and entrepreneurship , so that new ideas have a chance to be brought into play .	US ! country ;
Our continuing series Manhunt Sex Offenders on the Loose our effort to find missing offenders before they strike /.	Manhunt Sex Offenders on the Loose ! art ;
Authorities tell us that he had been subdued by the time the first responders arrived here so that he was subdued by staff here at the school /.	first ! order ;
That a fighting force should be best attuned to the battlefield and adversary of the moment -- modern , adaptable , quick , and informed -- should have been self - evident , on the order of the bloody lesson 80 years before of the Tsarist cavalry charging entrenched machine guns in the Russo - Japanese War .	80 years ! date ; Tsarist ! national ; the Russo - Japanese War ! thing ;
The municipal area is 23,114 square kilometers , occupying 4 % of the total area of Sichuan Province , within which the downtown area is 1,534 square kilometers .	23,114 square kilometers ! measure ; 4 % ! per ; Sichuan Province ! country ; 1,534 square kilometers ! measure ;
The ten provinces and cities totally exported 162.19 billion US dollars , accounting for 88.8 % of that of the whole country .	ten ! num ; 162.19 billion US dollars ! money ; 88.8 % ! per ;
Among the responses the Swiss trader got was one from the Soviet national shipping company , which had n't been invited to submit a bid .	Swiss ! national ; Soviet ! national ;
Posting station : BBS Unnamed space station -LRB- Wed Jan 24 00:42:30 2007 -RRB- .	Wed Jan 24 00:42:30 2007 ! date ;
So take a private investor .. any private investor who `` proposes '' to build a major road - like 460 - and folks will fall all over themselves about their good fortune ...	460 ! fact ;
In English it means zeal .	English ! language ;
The President has made the peace process in Northern Ireland a key foreign policy priority .	Northern Ireland ! country ;
The September 21 earthquake last year was the final straw .	The September 21 earthquake last year ! thing ;
Reports showing a rebound in New York 's manufacturing sector is helping to fuel that optimism today .	New York 's ! country ; today ! date ;
He also embossed the name for the Jiujiang Station .	the Jiujiang Station ! fact ;
and then the second night they had scheduled %uh a cruise you know on the Spirit of Baltimore you know	second ! order ; Baltimore ! country ;
In the wake of the failed Panama coup , a bumper sticker appears : `` Ollie Would Have Got Him . '' ...	Panama ! country ;
Vegetables are abundant and full of flavor in Poland , the pickles and sauerkraut sublime , the state monopolies long broken .	Poland ! country ;
and he said he 's not going to run for another term because it would be destabilizing not going to ask to change the constitution /.	constitution ! law ;
Spanish anti-bombs technicians have been busy this week .	Spanish ! national ; this week ! date ;
The European community wants to lift sanctions as early as Monday .	European ! national ; Monday ! date ;
Right now about a dozen laboratories , in the U.S. , Canada and Britain , are racing to unmask other suspected tumor - suppressing genes .	Right now about a dozen ! time ; U.S. ! num ; Canada ! country ; Britain ! country ;
Although sports officials predict jumps of 50 % to 100 % in the major contracts coming up for renewal , ad rates may rise only 20 % .	50 % to 100 % ! per ; only 20 % ! per ;
and I 'll be taking the job of the director of %um the English language program of a private university %uh in Atlanta a larger university .	English ! language ; Atlanta ! country ;
The naturally colored carpets produced by this factory won the " Pegasus " high quality prize awarded by Liaoning Province last year .	the " Pegasus " high quality prize ! art ; Liaoning Province last year ! country ;
Also , people who had mortgages against their property prior to the earthquake , and whose homes have been officially confirmed as destroyed , will have the interest payments delayed for five years .	five years ! date ;
The message writing process of each Enigma is mind - bogglingly complex .	Enigma ! product ;
An orbiter called Mars Express .	Mars Express ! product ;
The speedometer needle jumped : 110 , 120 , 140 .	110 ! num ; 120 ! num ; 140 ! num ;
As I have been hammering away relentlessly on this blog -LRB- See `` A World with One Billion Cars '' -RRB- , the world economy is moving from a 20 - year era of cheap petroleum to a plateau of more expensive petroleum .	A World with One Billion Cars ! art ; 20 - year ! date ;
For those enterprises that , without any legitimate reason , have been in long - term arrears in national tax payments , the tax department will , in accordance with relevant regulations in the " tax and management laws " , adopt taxation preservation measures against them .	the " tax and management laws " ! law ;
`` The Wall Street Journal '' reports the break - in was discovered Wednesday .	`` The Wall Street Journal '' ! art ; Wednesday ! date ;
and the project will also include a residential district with an area of 2 million square meters , shopping areas and an educational area as well as areas for commercial offices , entertainment , tourism and hotels .	2 million square meters ! measure ;
At that time , many commentators suggested that Love was successful largely because of the use of Taiwanese .	Love ! art ; Taiwanese ! language ;
Although the recent spill in Taiwan was small in comparison with 10,000 - ton spills that have occurred elsewhere , the situation here is worrisome because , as a petroleum importer , oil tankers ply the waters around our island in swarms .	Taiwan ! country ; 10,000 - ton ! measure ;
Another first /?	first ! order ;
A thousand tons of fuel oil began pouring through the ship 's torn hull .	A thousand tons ! measure ;
We realize that many of the people joining us here tonight for this broadcast are doing so to try to get more information .	tonight ! time ;
`` For the first time in my life , I was n't sure whether I was listening to our news or West German television . ''	first ! order ; West German ! national ;
The problem is not in the unavailability of Islamic legislative evidence upon which Islamic justice is based ; but rather in a reality in which you live and in which justice is excluded .	Islamic ! national ; Islamic ! national ;
As usual , estimates on the fickle report are wide , running from a drop of 3.5 % to a gain of 1.6 % .	3.5 % ! per ; 1.6 % ! per ;
The companies are followed by at least three analysts , and had a minimum five - cent change in actual earnings per share .	at least three ! num ; five - cent ! money ;
what 's the answer that you give since most of these terrorists since nine eleven and even earlier have been Muslims have been Middle Eastern origin /?	nine eleven ! thing ; Muslims ! national ; Middle Eastern ! national ;
State law requires a recount when the margin of victory is less than one half of 1 percent .	one half of 1 percent ! per ;
The target of this accountability is joint - stock companies including real estate companies , industrial companies , and others , many of which took the last dime in the pockets of people who yearned for wealth and wanted to expel the ghost of poverty from their lives .	dime ! money ;
And there are still several thousand absentee votes .	several thousand ! num ;
Uh this last year in tourism increased sixty - seven percent in Rwanda /.	this last year ! date ; sixty - seven percent ! per ; Rwanda ! country ;
What about the three main candidates ?	three ! num ;
As for trains , forget it unless your goods are travelling 600 miles or so , and happen to be gong in the same direction as the tracks .	600 miles ! measure ;
He emphatically introduced our country 's achievements during the seventh ' Five - year Plan ' , and the guiding principles of the three steps for achieving modernization .	seventh ! order ; Five - year ! date ; three ! num ;
For example , a child in her early teens might babysit for the neighbors or cut lawns , and then put the money in a mutual fund .	her early teens ! date ;
The ceiling would be lifted to 21.5 million barrels to provide Kuwait and the United Arab Emirates much higher official quotas while reducing percentage shares of some others .	21.5 million barrels ! measure ; Kuwait ! country ; the United Arab Emirates ! country ;
They weighed under two hundred pounds /.	under two hundred pounds ! measure ;
I mean there are lots of places where people could eat relatively inexpensively around the Barclay	Barclay ! fact ;
The third main artery of China connecting the south and the north , the Beijing - Kowloon railroad , was completed successfully in 1995 .	third ! order ; China ! country ; the Beijing - Kowloon railroad ! fact ; 1995 ! date ;
she loves like being under the red material under the chairs	under ! language ;
In a hopeless position , the computer resigned rather than make its 37th move .	37th ! order ;
He flies one of the As behind me , the Warthog attack planes .	Warthog ! product ;
Sterling was quoted at $ 1.6030 , up from $ 1.5885 late Friday .	1.6030 ! money ; 1.5885 late Friday ! money ;
CERTIFICATES OF DEPOSIT : 8.09 % one month ; 8.09 % two months ; 8.06 % three months ; 8 % six months ; 7.94 % one year .	8.09 % one month ! per ; 8.09 % two months ! date ; 8.06 % three months ! per ; 8 % six months ! date ; 7.94 % one year ! per ;
`` The second time , '' he says , `` they left the shovel . ''	second ! order ;
Islamist leaders have also accused security forces of preventing voters from entering polling stations in areas where the opposition is strong .	Islamist ! national ;
If `` Mancuso FBI '' has an intriguing central character , it also has a major flaw :	Mancuso FBI ! art ;
For instance , the senior senator from New York is hardly camera - shy .	New York ! country ;
The US Tennis Open is the last open match to take place among the four matches in the Tennis Grand Slam .	The US Tennis Open ! thing ; four ! num ; the Tennis Grand Slam ! thing ;
it 's two weeks away .	two weeks ! date ;
Building is something like 20 % of the economy .	20 % ! per ;
We 're talking about a 3 1 / 2 - pound human being .	3 1 / 2 - pound ! measure ;
I am referring to those young men who chose to disobey their country 's call to arms during the Vietnam war and fled to Canada or some other sanctuary to avoid combat .	the Vietnam war ! thing ; Canada ! country ;
According to information , China , in recent years , has successively discovered bird fossils from the early Mesozoic period in provinces such as Gansu , Hebei , Inner Mongolia , Liaoning , etc .	China ! country ; recent years ! date ; the early Mesozoic period ! date ; Gansu ! country ; Hebei ! country ; Inner Mongolia ! country ; Liaoning ! country ;
Of the remaining , 10 can be found in the Hsinchu Science Park .	the Hsinchu Science Park ! fact ;
It was learned that China currently has about 66 million square meters of commercial housing overstocked .	China ! country ; about 66 million square meters ! measure ;
This evening , police withdrew from the streets of Belgrade .	This evening ! time ; Belgrade ! country ;
As a result of the attacks of young men and some old men in the past !! Throughout the match they were repeating the phrase " Saudi hah hah , Saudi hah hah , " and they would not stop repeating it until the lights of the stadium were turned off !!	Saudi ! national ; Saudi ! national ;
It is not appropriate to take milk as the only drink in the early morning .	the early morning ! time ;
`` Yet even a relatively strong number -- 2.8 % to 2.9 % -- wo n't alter the market 's view that the economy is softening . ''	2.8 % to 2.9 % ! per ;
So how do people celebrate Chinese New Year nowadays ?	Chinese New Year ! thing ;
Final think evening -- on this Halloween , witchcraft .	evening ! time ; Halloween ! date ;
" The primary English program is not a subject like mathematics or Chinese .	English ! language ; Chinese ! language ;
The fire , near the historic State Park started yesterday when a trailer , hauled by a pickup , ignited on the Golden State Freeway .	State Park ! fact ; yesterday ! date ; the Golden State Freeway ! fact ;
Nevertheless many people have reservations about the pronunciation of the English teachers in our primary schools .	English ! language ;
Policy statement P - 5 - 39 sets out terms .	P - 5 - 39 ! law ;
For a week now , protesters have been clashing with police and backers of the clerical regime in Tehran .	a week ! date ; Tehran ! country ;
I mean you would n't think of translating it into English	English ! language ;
Over 4000 guests from home and abroad attended the opening ceremony .	Over 4000 ! num ;
Few American officials were willing any longer to defend him .	American ! national ;
I do n't even know if I even want to tackle a Spanish yet	Spanish ! language ;
Economic and technology cooperation completed 28.3 million US dollars , which was 1.5 times that of the previous year .	28.3 million US dollars ! money ; 1.5 ! num ; the previous year ! date ;
Afghan guerrillas bombarded Kabul in a weekend assault that Western diplomats called one of the biggest offensives since the Soviet Union completed a troop withdrawal in February .	Afghan ! national ; Kabul ! country ; weekend ! date ; the Soviet Union ! country ; February ! date ;
By the Constitution and everything else is in charge of Iraq /.	Constitution ! law ; Iraq ! country ;
With no power , more than 300 feet down , it 's believed any survivors would have frozen to death within hours , well before they ran out of air .	more than 300 feet ! measure ; hours ! time ;
Turning to Wall Street , disappointing auto sales are denting the shares of the Big Three .	Wall Street ! fact ;
They , two , were hit .	two ! num ;
I got to know her a bit better .	better ! language ;
Due to the reported failures of all efforts of the heavy - duty transport spaceship " Progress M - 24 " , which is delivering cargo to " Peace " , to dock with the orbital station , the food on the " Peace " orbital station , which lacks supplies , is only enough for the three Russian astronauts working on the orbital station to last for 10 days before the routine scientific research work of the astronauts would be affected .	" Progress M - 24 " ! fact ; Peace ! fact ; Peace ! fact ; three Russian ! num ; 10 days ! national ;
Other opponents of Filipino come from non-Tagalog regions .	Filipino ! language ; non-Tagalog ! language ;
What other people call normal I would have to climb there every single day /.	every single day ! date ;
One would hope that some kind of safeguards have been put into the Va Public - Private Law to deal with this potential .	the Va Public - Private Law ! law ;
This meeting will end on September 8th .	September 8th ! date ;
When you look at the Ballston Corridor , those high rises were essentially subdivided from property formerly owned as single family homes .	the Ballston Corridor ! fact ;
The 59.6 carat pink diamond just unveiled in Monaco is on display for the first time , its owners confident it is secure .	59.6 carat ! measure ; Monaco ! country ; first ! order ;
The Clean Air bill -LRB- quack -RRB- .	Clean Air ! law ;
Listening to `` God Save the Queen . ''	God Save the Queen ! art ;
Now back to the Abrams report /.	the Abrams report ! art ;
One of the artist 's earliest Fax works was `` Little Stanley Sleeping , '' a portrait of his dog .	One ! num ; Little Stanley Sleeping ! art ;
The A320 model is one commonly used only on minor routes .	A320 ! product ;
The changes apply to prosecutions brought under the Racketeer Influenced and Corrupt Organizations law .	Racketeer Influenced and Corrupt Organizations ! law ;
The lyric chosen -- `` long strange night '' -- may be an apt footnote to television spots by both candidates intended to portray each other as a liar .	long strange night ! time ;
So many Chinese have been to Hangzhou .	Chinese ! national ; Hangzhou ! country ;
It is the seed 's colorlessness and size -- 1,000 of them weigh only 1.5 grams , or about as much as two paper clips -- that explain the historical allusions to fleas .	1,000 ! num ; only 1.5 grams ! measure ; about as much as two ! num ;
The suit sets the firms ' liability at more than $ 185 million .	more than $ 185 million ! money ;
After receiving his discharge he borrowed NT$ 12,000 from his father , hired a baker , and opened up a store .	NT$ 12,000 ! money ;
The junk market , which mushroomed to $ 200 billion from less than $ 2 billion at the start of the decade , has been declining for months as issuers have stumbled under the weight of hefty interest payments .	$ 200 billion ! money ; less than $ 2 billion ! money ; the start of the decade ! date ; months ! date ;
Democrats winning in both of those states we can show you here /.	Democrats ! national ;
Unfilled orders for durable goods rose 0.4 % in September , to $ 476.14 billion , after declining for the first time in 2 1/2 years in August .	0.4 % ! per ; September ! date ; $ 476.14 billion ! money ; first ! order ; 2 1/2 years ! date ; August ! date ;
The Huguenot Trail road widening was already planned , due to the heavy demands of development on the Chesterfield side , the new schools , and a whole bunch of existing developments that were zoned years ago and at that time funneled through Robious Road .	Huguenot Trail ! fact ; Chesterfield ! country ; Robious Road ! fact ;
hold on one second okay	one second ! time ;
We 're coming up on 23 after the hour on what is shaping up to be a busy day here , but a joyous day for 5,000 sailors and Marines and friends and family in the San Diego , California area because the giant U.S. carrier Constellation is now returning home from the war in Iraq .	23 after the hour ! time ; a busy day ! date ; a joyous day ! date ; 5,000 ! num ; Marines ! national ; San Diego ! country ; California ! country ; U.S. ! country ; Constellation ! product ; Iraq ! country ;
and like he drove by in his B M W	B M W ! product ;
Police suspect that the criminals , who dig up the plants in the dead of night , are selling them to nurseries or landscapers .	night ! time ;
Sterling was quoted at $ 1.6055 , up from $ 1.6030 late Monday .	1.6055 ! money ; 1.6030 late Monday ! money ;
`` Thus we judge it to be not a violation of the ABM treaty at this time . ''	ABM ! law ;
Life for him , his wife and his 6 children has been very difficult .	6 ! num ;
Welcome back to Hardball /.	Hardball ! art ;
That 's until Thursday night 's debate .	Thursday night 's ! time ;
A quiet New Year	New Year ! thing ;
Taiwanese was no longer taboo , and indeed identification with " Taiwanese-ness " came to be highly admired .	Taiwanese ! language ;
The " Pentium " Cup National Track And Field Championship Competition drew to an end at the Tangshan Sports Center of Hebei province this morning .	The " Pentium " Cup National Track And Field Championship Competition ! thing ; the Tangshan Sports Center ! fact ; Hebei province this morning ! country ;
This was vital because , during the planning stage for the museum , it was decided to establish a very special room to be called " Echoes Across Space - Time . "	" Echoes Across Space - Time ! art ;
His private plane arrived at Heathrow Airport .	Heathrow Airport ! fact ;
The second : a Saudi woman devoid of bashfulness who has not been brought up well by her parents and lived outside Saudi Arabia more than she lived inside it .	second ! order ; Saudi ! national ; Saudi Arabia ! country ;
By the way , the First Lady of Qatar , we knew ........	First ! order ; Qatar ! country ;
but I liked English Literature	English ! language ;
um in terms of where they are trying to attain a goal of a hundred percent readiness they 're at sixty percent /.	a hundred percent ! per ; sixty percent ! per ;
The government said today it 's going to cut back on the enormous number of people who descended on Yemen to investigate the attack on the `` USS Cole . ''	today ! date ; Yemen ! country ; the `` USS Cole ! product ;
I think I lost 5 inches around my tummy .	5 inches ! measure ;
We got the Washingtonian	Washingtonian ! art ;
I mean the Barclay , which is right across the street , will	Barclay ! fact ;
and I spent $ 48 filling up the gas tank of my Jeep --	$ 48 ! money ; Jeep ! product ;
but in the state of New York you 're not allowed to simply tell the authorities something that 's not true and send them going elsewhere /.	New York ! country ;
Called The Misfit	The Misfit ! art ;
My office , home and children 's schools are all within a 6 mile radius .	6 mile ! measure ;
The two nations are still bitter enemies .	two ! num ;
