Turnover surged to EUR61 .8 m from EUR47 .6 m due to increasing service demand , especially in the third quarter , and the overall growth of its business .	positive
The company anticipates its turnover for the whole 2010 to surpass that of the previous year when it was EUR 67.1 million .	positive
LONDON MarketWatch -- Nokia nok said it 's won a five-year services contract to run Hutchison Essar 's network operations in nine locations in India .	positive
Finnish Suominen Corporation that specialises in wet wipes , nonwovens , and flexible packaging reports net sales of EUR 44.1 mn in the second quarter of 2010 , up from EUR 43.3 mn in the second quarter of 2009 .	positive
It will also strengthen Ruukki 's offshore business .	positive
Both operating profit and net sales for the three-month period increased , respectively from EUR15 .1 m and EUR131 .5 m , as compared to the corresponding period in 2005 .	positive
HELSINKI ( Thomson Financial ) - Kone said it has won four orders in Saudi Arabia , United Arab Emirates and Qatar worth 40 mln eur .	positive
In the first quarter of 2010 , the mark-to-market result was a pretax profit of EUR 133 million versus a loss of EUR 32 million in the same period last year .	positive
Diluted earnings per share ( EPS ) rose to EUR 0.29 from EUR 0.05 .	positive
It estimates the operating profit to further improve from the third quarter .	positive
EPS from continuing operations came in at 0.30 eur , up from 0.17 .	positive
Last year SysOpen Digia invested in IBM product know-how in the building of portal and trading place systems and successfully implemented customer solutions supported by it .	positive
Finnish Vacon has signed significant deals with Norwegian Scandinavian Electric Systems ( SES ) on the supply of AC drives .	positive
The operating profit for Grain Trading increased to EUR 2.0 mn from EUR 1.4 mn in 2005 .	positive
Operating profit totaled EUR 37,7 mn , up slightly from EUR 37.2 mn in the corresponding period in 2006 .	positive
Finnish broadband data communication systems provider Teleste Oyj HEL : TLT1V said yesterday it returned to a net profit of EUR 2.7 million USD 3.8 m for the first nine months of 2010 versus a net loss of EUR 579,000 for the same period of 2009 .	positive
Operating loss totaled EUR 25mn compared to a profit of EUR 63mn in the corresponding period in 2005 .	negative
Finnish Exel Composites , a technology company that designs , manufactures , and markets composite profiles and tubes for various industrial applications , reports its net sales decreased by 0.6 % in the second quarter of 2010 to EUR 19.2 mn from EUR 19.3 mn in the corresponding period in 2009 .	negative
The Baltimore Police and Fire Pension , which has about $ 1.5 billion , lost about $ 3.5 million in Madoff Ponzi scheme .	negative
Food sales totalled EUR 323.5 mn in October 2009 , representing a decrease of 5.5 % from October 2008 .	negative
Finnish Kemira 's net sales EUR decreased to EUR 1,259.6 mn in January-June 2009 from EUR 1,425.1 mn in January-June 2008 .	negative
Production levels have been agreed with producers a long time ago , so a fall in consumption will lead to losses .	negative
Insurer Axa ( PAR : CS ) slid by 5.35 % to EUR 14.15 , after Citigroup and ING slashed their targets on the stock .	negative
11 August 2010 - Finnish measuring equipment maker Vaisala Oyj HEL : VAIAS said today that its net loss widened to EUR4 .8 m in the first half of 2010 from EUR2 .3 m in the corresponding period a year earlier .	negative
Finnair 's Tallinn-based subsidiary , Aero AS , carried 23,335 passengers , a decline of 60.8 % , on routes between Helsinki and the Baltic capitals and within Southern Finland .	negative
In the building and home improvement trade , sales decreased by 6.3 % , totalling EUR 154.1 mn .	negative
Salonen added that data shows producers ' pulp inventories in North America are declining . '	negative
L&T 's net profit for the whole 2010 dropped to EUR 36 million from EUR 45 million for 2009 .	negative
Operating loss before non-recurring items was EUR 0.9 mn , compared to a profit of EUR 11.5 mn in 2008 .	negative
Operating profit , excluding non-recurring items , totaled EUR 0.2 mn , down from EUR 0.8 mn in the corresponding period in 2006 .	negative
Operating loss totaled EUR 0.3 mn compared to a profit of EUR 2.2 mn in the corresponding period in 2007 .	negative
Finnish media group Talentum has issued a profit warning .	negative
In addition , the contract includes modification of the effluent treatment plant at Follum .	neutral
Neste Oil will publish its third quarter 2008 results on Friday , 24 October 2008 at approximately 9 am ( EET ) .	neutral
The train is expected to cross the Russian territory in 9 days , reaching the Vostochny port .	neutral
Simmons Elected DCUC Chairman PORTSMOUTH , N.H.-Gordon A. Simmons , CEO of Service Credit Union , has been elected chairman of the Defense Credit Union Council for the 2007-2008 term .	neutral
The building will house , for example , Respecta Oy 's Jyvaskyla premises , as well as other companies to be announced later , says Samuel Koivisto , Director of Technopolis operations in Jyvaskyla .	neutral
The price of the 10,000 kroon par value bonds was 9663,51 kroons in the primary issue .	neutral
The fish content of the nuggets is 85 % , and the fish comes from Canada and Finland .	neutral
HK Ruokatalo 's target is to know the consumers .	neutral
Fortum expects its annual capital expenditure in the next four to five years to be within a range of EUR 0.8-1 .2 billion , as earlier announced .	neutral
Conference Call To participate via a conference call , please dial in 5-10 minutes before the beginning of the event : +44 0 20 7162 0025 Europe or +1 334-รก323-รก6201 USA .	neutral
BAVARIA Industriekapital AG 's 2006 revenues were EUR 333 million , with an EBITDA of EUR 51 million .	neutral
Ahlstrom 's share is quoted on the NASDAQ OMX Helsinki .	neutral
The 2500-passenger ferry will have dimensions of 185 m length overall , 170 m length between perpendiculars , 27.70 m breadth and 6.55 m design draught .	neutral
Vehvilainen , who is currently the chief operating officer at Nokia Siemens Networks , will join Finnair on 5 January 2010 and take over as CEO effective 1 February 2010 .	neutral
The inventors are Bylander Johan , Ponten Fredrik and Lundberg Jorgen .	neutral
The value of the contract is about EUR 27mn .	neutral
